{
	"waves": {
	
		"wave_1" : [[1, 1, 1, 1, 1, 1, 1, 1],
	                [1, 1, 1, 1, 1, 1, 1, 1],
	                [1, 1, 1, 1, 1, 1, 1, 1],
	                [1, 1, 1, 1, 1, 1, 1, 1],
	                [1, 1, 1, 1, 1, 1, 1, 1]],
	              
	    "wave_2" : [[0, 1, 1, 1, 1, 1, 1, 0],
	                [0, 1, 1, 2, 2, 1, 1, 0],
	                [0, 1, 1, 2, 2, 1, 1, 0],
	                [0, 1, 1, 2, 2, 1, 1, 0],
	                [0, 1, 1, 1, 1, 1, 1, 0]],
	                
        "wave_3" : [[0,0,0,  0,0,0,0],
        			[0,0,0,  0,0,0,0],
        			[0,0,0,  0,0,0,0],
        			[0,0,0,100,0,0,0]]       
	   },
	   
	   "timeLimit" : 300
	   
	   
}